111111111111111111111111111111111111
1E00000000000000000C0000C00000000001
101000000000000000000000000000000001
1010000000000000000C00000000000000C1
101000000000000100000000000000000001
1P1000000000000000000000000000000001
111111111111111111111111111111111111
